111111111111111111111111111
1000C0000000E00000000110001
11100100001000G010100111101
1010010G0010101010100000101
1010010000101011P0100110101
10100100001010101010011C101
111111111111111111111111111